6 8
____**_*
_*_*___*
_*_*_*_*
_*___*_*
__****_*
____**__
