__@_@@@___
@_@____@__
@___@__@__
@_@_______
@_@____@__
__@____@_@
@______@__
@_@_@@__@_
@_@_@@@@__
__@_____@_
